AIX 	- Advance Interactive eXecutive
WCF 	- Windows Communication Foundation
WWF 	- Window workflow Foundation
REST 	- Representation State Transfer
XSD 	- XML Schema Definition
XSL 	- Extensible Stylesheet Language
QA 		- Quality Assurance
WSDL 	- Web Service Description Language
SOAP 	- Simple Object Access Protocol
ALM		- Application Life cycle Management
LTS 	- Long Term Support

=======================================
############### TOOL ##################

STS - Spring Tool Suite
RCP - Rich Client Platform
RAP - Remote Appl Platform
=======================================
############# JAVA WORLD ##############

JCP 	- Java Community Process
JSR 	- Java Specification Requests
JEP		- JDK Enhancement Proposals

JDK 	– Java Development Kit
JVM 	– Java Virtual Machine
EJB 	- Enterprise JavaBean
WAR 	- Web ARchive
JAR 	- Java ARchive
JPA 	- Java Persistence API
JSF 	- Java Server Faces
JSTL 	- JSP Standard Tag Libarary
TLD 	- Tag Library Descriptor
JNDI 	- Java Naming Directory Interface

=======================================


SDK 	– Software Development Kit
IDE 	– Integrated Development Envirnment

SRS 	– Software Requirement Specification
SDLC 	– Software Development Life Cycle
DFD 	– Data flow diagram
ER 		– Entity Relationship
WTP 	- Web tool Project
=======================================
########## OBJECT Oriented ############

OOP 	– Object oriented paradigm
OOAD 	– Object Oriented Analysis & Design
OOD 	– Object Oriented Design
AOP 	- Aspect Oriented Programming
DAO 	- Data Access Object 
=======================================
###### ALGORITHM & DATA STRUCTURE #####

UML 	– Unified Modeling Language
ADT 	– Abstract Data Type
MVC 	- Model View Controller 

=======================================
MIME - Multipurpose internet mail extension


ETL 	- Extract, Transform and Loads
S3 		- Simple Storage service
EMR 	- elastic MapReduce
DAG 	- directed acyclic graph
RDD 	- Resilient Distributed Dataset
UDF 	- user-defined functions 
CLI 	- Command Line Interface
=======================================
############ NETWORKING ###############

UDDI 	- Universal Description, Discovery and Integration 
CORBA 	- Common Object Request Broker Architecture
LDAP 	- LightWeight Directory Access Protocol
SSL 	- Secure Socket Layer
VoIP 	- voice-over-IP 
OSI 	- Open Systems Interconnection 
TLS 	- Transport Layer Security
MD5 	- Message Digest Algo
SHA 	- Secure Hash Algo.
RFC 	- Request for Comments 
WSS 	- Web Service Security
UTF 	- Unicode Transformation Format (UTF)
SSH 	- Secure Shell
=======================================
############# SECURITY ################

SAML 	- Security Assertion Markup Language
SCP 	- Secure Copy
EV 		- Extended Validation Certificate is an X.509 public key certificate issued according to a specific set of identity verification criteria by Certificate Authority(CA)
